WWWWWWWWWWWWWWWWWWWWWWWWWWWWWWWWWWWWWWWWWWWWWWW
WFFFFFFFFFFFFFFFFFFWWWWWWWWWFFFFFFFFFFFFFFFFFFW
WFFFFFFFFPFFFFFFFFFWWWWWWWWWFFFFFFFFFHFFFFFFFFW
WFFFFFFFFFFFFFFFFFFWWWWWWWWWFFFFFFFFFFFFFFFFFFW
WFFFFFFFFOFFFFFFFFFWWWWWWWWWFFFFFFFFFFFFFFFFFFW
WFFFFFFFFFFFFFFFFFFWWWWWWWWWFFFFFFFFFFFFFFFFFFW
WFFFFFFFFFFFFFFFFFFWWWWWWWWWFFFFLFFFFFFFFFLFFFW
WFFFFFFFFFFFFFFFFFFWWWWWWWWWFFFFFFFFFFFFFFFFFFW
WFFFFFFFFFFFFFFFFFFWWWWWWWWWFFFFFFFFFFFFFFFFFFW
WFFFFFFFFFFFFFFFFFFWWWWWWWWWFFFFFFFFFFFLFFFFFFW
WFFFFFFFFFFFFFFFFFFWWWWWWWWWFFFFFFFFFFFFFFFFFFW
WFFFFLFFFFFFFFFFFFFWWWWWWWWWFFFFFFFFFFFFFFFFFFW
WFFFFFFFFFFFFFFFFFFWWWWWWWWWFFFFFFFFFFFFFFFFFFW
WFFFFFFFFFFFFFLFFFFWWWWWWWWWFFFFFLFFFFFFFFFFFFW
WFFFFFFFFFFFFFFFFFFWWWWWWWWWFFFFFFFFFFFFFFFFFFW
WFFFFFFFFFFFFFFFFFFWWWWWWWWWFFFFFFFFFFFFFFFFFFW
WFFFFFFFFFFFFFFFFFFWWWWWWWWWFFFFFFFFFFFFFFFFFFW
WFFFFFFWWWWWWWWWWWWWWWWWWWWWWWWWWWWWWWWWFFFFFFW
WFFFFFFFFFWFFFFFFFFFFFFFFFFFFFFFFFFFWFFFFFFFFFW
WFFFFFFFBFWFFFFFFFFFFFFFFFFFFFFFFFFFWFBFFFFFFFW
WFFFFFFFFFWFFFFFFFFFFFFFFFFFFFFFFFFFWFFFFFFFFFW
WFFFFFFFFFWFFFFFFFFFFFFDFFFFFFFFFFFFWFFFFFFFFFW
WFFFFFFFFFWFFFFFFFFFFFFFFFFFFFFFFFFFWFFFFFFFFFW
WFFFFFFFFFFFFFFFFFFFFFFFFFFFFFFFFFFFFFFFFFFFFFW
WFFFFFFFFFFFFFFFFFFFFFFFFFFFFFFFFFFFFFFFFFFFFFW
WFFFFFFFFFFFFFFFFFFFFFFFFFFFFFFFFFFFFFFFFFFFFFW
WFFFFFFFFFFFFFFFFFFFFFFFFFFFFFFFFFFFFFFFFFFFFFW
WWWWWWWWWWWWWWWWWWWWWWWWWWWWWWWWWWWWWWWWWWWWWWW
