WWWWWWWWWWWWWWWWWWWWWWWWWWWWWWWWW
WFFFFFFFFFFFFFFFFFFFFFFFFFFFFFFFW
WFFFFFFFFFFFFFFFLFFFFFFFFFFFFFFFW
WFFFFFDFFFFFFFFFFFFFFFFFFFDFFFFFW
WFFFFFFFFFFFFFFFFFFFFFFFFFFFFFFFW
WFFFFFFFFFFWWFFFFFFFWWFFFFBFFFFFW
WFFFFFFFFFFWWFFFFFFFWWFFFFBFFFFFW
WFFFFFFFFFFWWFFFFFFFWWFFFFFFFFFFW
WFFFFFLFFFFWWFFFFFFFWWFFFFBFFFFFW
WFFFFFFFFFFWWFFFLFFFWWFFFFFFFFFFW
WFFFFFFFFFFWWFFFFFFFWWFFFFBFFFFFW
WFFFFFFFFFFWWFFFFFFFWWFFFFFFFFFFW
WFFFFFFFFFFWWFFFFFFFWWFFFFBFFFFFW
WFFFFFBFFFFWWFFFFFFFWWFFFFFFFFFFW
WFFFFFFFFFFWWFFFLFFFWWFFFFBFFFFFW
WFFFFFFFFFFWWFFFFFFFWWFFFFFFFFFFW
WFFFFFFFFFFWWFFFLFFFWWFFFFBFFFFFW
WFFFFFFFFFFWWFFFFFFFWWFFFFFFFFFFW
WFFFFFLFFFFWWFFFLFFFWWFFFFBFFFFFW
WFFFFFFFFFFWWFFFFFFFWWFFFFFFFFFFW
WFFFFFFFFFFWWFFFFFFFWWWWWWWWWWWWW
WFFFFFFFFFFWWFFFFFFFFFFFFFFFFFFFW
WFFFFFFFFFFWWFFFFFFFFFFFFFFFFFFFW
WFFFFFHFFFFWWFFFFFFFFFFFFFFFFFFFW
WFFFFFFFFFFWWFFFFFFFFFFFFFFFFFFFW
WFFFFFFFFFFWWFFFFFFFFFFFFFFFFFFFW
WWWWWWWWWWWWWFFFFFFFFFFDFFFFFFFFW
WFFFFFFFFFFFFFFFFFFFFFFFFFFFFFFFW
WFFFFFFFFFFFFFFFFFFFFFFFFFFFFFFFW
WFFFFFFFFFFFFFFFFFFFFFFFFFFFFFFFW
WFFFFPFFFFFFOFFFFFFFFFFFFFFFFFFFW
WFFFFFFFFFFFFFFFFFFFFFFFFFFFFFFFW
WWWWWWWWWWWWWWWWWWWWWWWWWWWWWWWWW
