WWWWWWWWWWWWWWWWWWWWWWWWWWWWWWWWWWWW
WFFFFFFFFFFFFFFFFFFFFFFWWFFFFFFFFFFW
WFFFFFFFFFFFFFFFFFFFFFFWWFFFFFFFFFFW
WFFFFFPFFFOFFFFFFFFFFFFWWFFFFHFFFFFW
WFFFFFFFFFFFFFFFFFFFFFFWWFFFFFFFFFFW
WFFFFFWWWWWWWWWWWWFWWWFWWFFFFFFFFFFW
WFFFFFFFFFFFFFFFFWFFFFFWWFFFFFFFFFFW
WFFFFFFFFFFFFFFFFWFFFFFWWFFFFFFFFFFW
WFFFFFFFFFFFFFFFFWFFFFFWWFFFFFFFFFFW
WFFFFFFDFFFFFFFFFFFFBFFFFFFFFFFFFFFW
WFFFFFFFFFFFFFFFFWFFFFFWWFFFFFFFFFFW
WFFFFFFFFFFFFFFFFWFFFFFWWFFFFFFFFFFW
WFFFFFFFFFFFFFFFFWFFFFFWWFFFFFFFFFFW
WFFFFFFFFFFFFFFFFWFFFFFWWFFFFFFFFFFW
WFFFFFFFFFFFFFFFFWFFFFFWWFFFFFFFFFFW
WFFFFFFFFFFFFFFFFWFFFFFWWFFFFFFFFFFW
WFFFFFFFFFFFFFFFFFFFBFFFFFFFFFFFFFFW
WFFFFFFDFFFFFFFFFWFFFFFWWFFFFFFFFFFW
WFFFFFFFFFFFFFFFFWFFFFFWWFFFFFFFFFFW
WFFFFFFFFFFFFFFFFWFFFFFWWFFFFFFFFFFW
WFFFFFFFFFFFFFFFFWFFFFFWWFFFFFFFFFFW
WFFFFFFFFFFFFFFFFWFFFFFWWFFFFFFFFFFW
WFFFFFFFFFFFFFFFFFFFBFFFFFFFFFFFFFFW
WFFFFFFFFFFFFFFFFWFFFFFWWFFFFFFFFFFW
WFFFFFFFFFFFFFFFFWFFFFFWWFFFFFFFFFFW
WFFFFFFDFFFFFFFFFWFFFFFWWFFFFFFFFFFW
WFFFFFFFFFFFFFFFFWFFFFFWWFFFFFFFFFFW
WFFFFFFFFFFFFFFFFWFFFFFWWFFFFFFFFFFW
WFFFFFFFFFFFFFFFFFFFBFFFFFFFFFFFFFFW
WFFFFWWWWWWWWWWWWWFFFFFWWFFFFFFFFFFW
WFFFFFFFFFFFFFFFFFFFFFFFFFFFFFFFFFFW
WFFFFFFFFFFFFFFFFFFFFFFFFFFFFFFFFFFW
WFFFFFFFFFFFFFFFFFFFFFFFFFFFFFFFFFFW
WFFFFFFFFFFFFFFFFFFFFFFFFFFFFFFFFFFW
WFFFFFFFFFFFFFFFFFFFFFFFFFFFFFFFFFFW
WWWWWWWWWWWWWWWWWWWWWWWWWWWWWWWWWWWW
