WWWWWWWWWWWWWWWWWWWWWWWWWWWWWWWWWWWWWWWWWWWWWW
WFFFFFFWFFFFFFFFFFFFFFFFFFFFFFFFFFFFFFFFFFFFFW
WFFPFFFWFFFFFFFFFFFFFFFFFLFFFFFFFFFFFFFFFFFFFW
WFFFFFFWFFFFFFFFFFFFFFFFFFFFFFFFFFFFFFFFFLFFFW
WFFFFFFWFFFFFFFFFFFFFFFFFFFFFFFFFFFFFFFFFFFFFW
WFFOFFFWFFFFFFFWWWWWWWWWWWWWWWWWWWWWWWFFFFFFFW
WFFFFFFWFFFLFFFWFFFFFFFFFFFFFFFFFFFFWWFFFFFFFW
WFFFFFFWFFFFFFFWFFFFFFFFFFFFFFFFFFFFWWFFFFFFFW
WFFFFFFWFFFFFFFWFFFFFLFFFFFFFFFFLFFFWWFFFFFFFW
WFFFFFFWFFFFFFFWFFFFFFFFFFFFFFFFFFFFWWFFFLFFFW
WFFFFFFWFFFFFFFWFFFFFWWWWWWWWWFFFFFFWWFFFFFFFW
WFFLFFFWFFFFFFFWFFFFFWFFFFFFWWFFFFFFWWFFFFFFFW
WFFFFFFWFFFFFFFWFFFFFWFFFFFFWWFFFFFFWWFFFFFFFW
WFFFFFFWFFFFFFFWFFFFFWFFFHFFWWFFFFFFWWFFFFFFFW
WFFFFFFWFFFFFFFWFFFFFWFFFFFFWWFFFFFFWWFFFFFFFW
WFFFFFFWFFFFFFFWFFFFFWFFFFFFWWFFFFFFWWFFFFFFFW
WFFFFFFWFFFLFFFWFFFFFWFFFFFFWWFFFFFFWWFFFLFFFW
WFFFLFFWFFFFFFFWFFFFFWFFFFFFWWFFFLFFWWFFFFFFFW
WFFFFFFWFFFFFFFWFFFFFWFFFFFFWWFFFFFFWWFFFFFFFW
WFFFFFFWFFFFFFFWFFLFFWFFFFFFWWFFFFFFWWFFFFFFFW
WFFFFFFWFFFFFFFWFFFFFWFFFFFFWWFFFFFFWWFFFLFFFW
WFFFFFFWFFFFFFFWFFFFFWFFFFFFWWFFFFFFWWFFFFFFFW
WFFFFFFWFFFFFFFWFFFFFWFFFFFFWWFFFFFFWWFFFFFFFW
WFFFFFFWFFFFFFFWFFFFFWFFFLFFWWFFFFFFWWFFFFFFFW
WFFFLFFWFFFFFFFWFFFFFWFFFFFFWWFFFFFFWWFFFFFFFW
WFFFFFFWFFFFFFFWFFFFFWFFFFFFWWFFFFFFWWFFFLFFFW
WFFFFFFWFFFFFFFWFFFFFWFFFFFFWWFFFFFFWWFFFFFFFW
WFFFFFFWFFFFFFFWFFFFFWFFFFFFWWFFFFFFWWFFFFFFFW
WFFFFFFWFFFFFFFWFFFFFWFFFFFFWWFFFLFFWWFFFFFFFW
WFFFFFFWFFFLFFFWFFFFFWFFFFFFWWFFFFFFWWFFFFFFFW
WFFFFFFWFFFFFFFWFFFFFWFFFFFFWWFFFFFFWWFFFFFFFW
WFFFFFFWFFFFFFFWFFLFFWFFFFFFWWFFFFFFWWFFFFFFFW
WFFFFFFWFFFFFFFWFFFFFWFFFFFFWWFFFFFFWWFFFFFFFW
WFFFFFFWFFFFFFFWFFFFFFFFFFFFWWFFFFFFWWFFFLFFFW
WFFFFFFWFFFFFFFWFFFFFFFFFFFFWWFFFFFFWWFFFFFFFW
WFFFFFFWFFFFFFFWWWWWWWWWWWWWWWFFFFFFWWFFFFFFFW
WFFFFFFWFFFFFFFFFFFFFFFFFFFFFFFFFFFFWWFFFFFFFW
WFFFFFFWFFFFFFFFFFFFFFFFFFFFFFFFFFFFWWFFFFFFFW
WFFLFFFWFFFFLFFFFFFFFDFFFFFFFFFLFFFFWWFFFFFFFW
WFFFFFFWFFFFFFFFFFFFFFFFFFFFFFFFFFFFWWFFFFFFFW
WFFFFFFWFFFFFFFFFFFFFFFFFFFFFFFFFFFFWWFFFLFFFW
WFFFFFFWWWWWWWWWWWWWWWWWWWWWWWWWWWWWWWFFFFFFFW
WFFFFFFFFFFFFFFFFFFFFFFFFFFFFFFFFFFFFFFFFFFFFW
WFFFFFFFFLFFFFFFFFFFFFFFFFFFFLFFFFFFFFFFFFFFFW
WFFFFFFFFFFFFFFFFFFFFFFFFFFFFFFFFFFFFFFFFFFFFW
WWWWWWWWWWWWWWWWWWWWWWWWWWWWWWWWWWWWWWWWWWWWWW
