WWWWWWWWWWWWWWWWWWWW
WFFFFFFFFFFFFFFFFFFW
WFFFFFFFFFFFFFFFHFFW
WFFFFFOFFFFFFFFFFFFW
WFFPFFFFFFFFFFFFFFFW
WFFFFFFFFFFFFFFFFFFW
WWWWWWWWWWWWWWWWWWWW
