WWWWWWWWWWWWWWWWWWWWWWWWWWWWWW
WFFFFFFFFFFFFFWWWWWWWWWWWWWWWW
WFFPFFOFFFFFFFFFFFFFFFFFFFWWWW
WFFFFFFFFFFFFFFFFFFFFFFFFFWWWW
WFFFFFFFFFFFFFFFFFFFFFFFFFWWWW
WFFFFFFFFFFFFFWWWWWFFFFFFFWWWW
WFFFFFFFFFFFFFWWWWWFFFFFFFWWWW
WWWWWWWWWWWWWWWWWWWFFFFFFFWWWW
WWWWWWWWWWWWWWWWWWWFFFFFFFWWWW
WFFFFFFFFFFFFFWWWWWFFFFFFFFFFW
WFFFHFFFFFFFFFWWWWWFFFFFFFFFFW
WFFFFFFFFFFFFFWWWWWFFFFFFFFFFW
WFFFFFFFFFFFFFWWWWWFFFFFFFFFFW
WFFFFFFFFFFFFFWWWWWFFFFFFFFFFW
WFFBFFFFFFFBFFWWWWWFFFLFFFFFFW
WFFFFFFFFFFFFFWWWWWFFFFFFFFFFW
WFFFFFFFFFFFFFWWWWWFFFFFFFFFFW
WFFFFFFFFFFFFFWWWWWFFFFFFFFFFW
WFFFFFFFFFFFFFWWWWWFFFFFFFFFFW
WFFFFFFDFFFFFFWWWWWFFFFFFFFFFW
WFFFFFFFFFFFFFWWWWWFFFFFFFLFFW
WFFFFFFFFFFFFFWWWWWFFFFFFFFFFW
WFFFFFFFFFFFFFWWWWWFFFFFFFFFFW
WFFFFFFFFFFFFFFFFFFFFFFFFFFFFW
WFFFFFFFFFFFFFFFFFFFFFFFFFFFFW
WFFFFFFFFFFFLFFFFFFFFFFFFFFFFW
WFFFFFFFFFFFFFFFFFFFFFFFFFFFFW
WFFFFFFFFFFFFFFFFFFFFFFFFFFFFW
WWWWWWWWWWWWWWWWWWWWWWWWWWWWWW
