WWWWWWWWWWWWWWWWWWWWWWWWW
WFFFFFFWFFFFFFFFFFFFFFFFW
WFFHFFFWFFFFFFFFFFFFLFFFW
WFFFFFFFFFFFFFFFFFFFFFFFW
WFFFFFFFFFFLFFFFFFFFFFFFW
WFFFFFFWFFFFFFFFFFFFFFFFW
WFFFFFFWFFFFFFFFFFFFFFFFW
WWWWWWWWWWWWWWWWFFFFFFFFW
WFFFFFFFFFFFFFFFFFFFFFFFW
WFFFFFFFFFFFFFFFFFFFFFFFW
WFFFFFFFFFFFFFFFFFFFFFDFW
WFFOFFFFFFFFFFFFFFFFFFFFW
WFFFFFFFFFFFFFFFFFFFFFFFW
WFFPFFFFFFFFFFFFFFFFFFFFW
WFFFFFFFFFFFFFFFFFFFFFFFW
WWWWWWWWWWWWWWWWWWWWWWWWW
