WWWWWWWWWWWWWWWWWWWWWWWWWWWWWWWWWWWWWWWWW
WFFFFFFFFFFFFFFFFFFFFFFFFFFFFFFFFFFFFFFFW
WFFFFHFFFFFBFFFFFFFFFFFBFFFFFFFFFFBFFFFFW
WFFFFFFFFFFFFFFFFFFFFFFFFFFFFFFFFFFFFFFFW
WWWWWFFFFFFFFFFLFFFFFFFFFFFFLFFFFFFFFFFFW
WFFFWFFFFFFFFFFFFFFFFFFDFFFFFFFFFFFFFFFFW
WFFFWFFFFFFFFFFFFFFFFFFFFFFFFFFFFFFFFFFFW
WFFFWFFFFFFFFFFFFFFFFFFFFFFFFFFFFFWWWFFFW
WFFFWFFFFFFFFFFFFFFFFFFFFFFFFFFFFFFFFFFFW
WFFFWFFFFFBFFFFFLFFFFFFBFFFFFLFFFFFBFFFFW
WFFFWFFFFFFFFFFFFFFFFFFFFFFFFFFFFFFFFFFFW
WFFFWFFFFFFFFFFWWWFFFFFFFFFFFFFFFFFFFFFFW
WFFFWFFFFFFLFFFFFFFFFFFFFFFFFFFFFFFFFFFFW
WFFFWFFFFFFFFFFFFFFFFFFFFFFFFFFFFFFFFFFFW
WFFFWFFFFFFFFFFFFFFFFFFFFFFFFFFFFFFFFFFFW
WFFFWFFFFDFFFFFFFFFFFWWFFFFLFFFDFFFFFFFFW
WFFFWFFFFFFFFFFFFFFFFWWFFFFFFFFFFFFFFFFFW
WFFFWFFFFFFFFFFFFFFFFFFFFFFFFFFFFFFFFFFFW
WFFFWFFFFFFFFFFFFFFFFFFFFFFFFFFFFFFFFFFFW
WFFFWFFFFFFFFFFFFFFFFFFFFFFFFFFFFFFFWFFFW
WFFFWWWWWWWWWWWWWWWWWWWWWWWWWWWWWWWWWFFFW
WFFFFFFFFFFFFFFFFFFPFFFFFFFFFFFFFFFFWFFFW
WFFFFFFFFFFFFFFFFFFFFFFFFFFFFFFFFFFFWFFFW
WFFFFFFFFFFFFFFFFFFFFFFFFFFFFFFFFFFFWFFFW
WFFFFFFFFFFFFFFFFFFOFFFFFFFFFFFFFFFFWFFFW
WWWWWWWWWWWWWWWWWFFFFFWWWWWWWWWWWWWWWFFFW
WFFFFFFFFFFFFFFFFFFFFFWFFFFFFFFFFFFFFFFFW
WFFFFFFFFFFFFFFFFFFFFFWFFFFFFFFFFFFFFFFFW
WFFFFFFFFFFFFFFFFFFFFFWFFFFFFFLFFFFFFFFFW
WFFFFFFFFFFFFFFFFFFFFFWFFFFFFFFFFFFFFFFFW
WFFFFFFFFFFFFFFFFFFFFFWFFFFFFFFFFFFFFLFFW
WFFFFWWWWWWWWWWWWWFFFFWWWWWWWFFFFFFFFFFFW
WFFFFFFFFFFFFFFFFWFFFFWFFFFFFFFFFFFFFFFFW
WFFFFFFFFFFFFFFFFWFFFFWFFFFFFFFFFFFFFFFFW
WFFFFFFFFFFFFFFFFWFFFFWFFFFFFFFFFFFFFFFFW
WFFFFFFFFFFFFFFFFWFFFFWFFFFFFFFFFFFFFFFFW
WFFFFFFFFFBFFFFFFWFFFFWFFFFFFFFLFFFFFFFFW
WFFFFFFFFFFFFFFFFWWWWWWFFFFFFFFFFFFFFFFFW
WFFFFFFFFFFFFFFFFFFFFFFFFFFFFFFFFFFFFFFFW
WFFFFFFFFFFFFFFFFFFFFFFFFFFFFFFFFFFFFFFFW
WWWWWWWWWWWWWWWWWWWWWWWWWWWWWWWWWWWWWWWWW
