WWWWWWWWWWWWWWWWWWWWWWWWWWWWWWWWWWWWWWWWWWWWWWWWWWW
WFFFFFFFFFFFFFFFFFFFFFFFFFFFFFFFFFFFFFFFFFFFFFFFFFW
WFFFFFFFFFFFFFFFFFFFFFFFFFFFFFFFFFFFFFFFFFFFFFFFFFW
WFFFFFFFFFFFFFFFFFFFFFWFFFFFFFFFFDFFFFFFFFFFFFFFFFW
WFFFFFFBFFFFFFFFFFFFFFWFFFFFFFFFFFFFFFFFFFFFFFFFFFW
WFFFDFFFFFFFFFFFLFFFFFWFFFHFFFFFFFFFFFFWWWWWWWFFFFW
WFFFFFFFFFFFFFFFFFFFFFWFFFFFFFFFFFFFFFFWWFFFFFFFFFW
WFFFFFFFFFFFFFFFFFFFFFWWWWWWWWWFFFFFFFFWWFFFFFLFFFW
WFFFFFFFFFFFBFFFFFFFFFFFFWWWWWWFFFFFFFFWWFFFFFFFFFW
WFFFFFFFFFFFFFFFFFFFFFFFFFFFFFFFFFFFFFFWWFFFFFFFFFW
WFFFFFFFFFFFFFFFFFFFFFFFFFFFFFFFFFFFFFFWWFFFFFDFFFW
WFFFFLFFFFFFFFFFFFFFFFFFFFFFFFFFFFFFFFFWWFFFFFFFFFW
WFFFFFFFWWWWWWWWWFFFFFFFFFFFFFFFFFFFFFFWWFFFFFFFFFW
WFFFFFFFWFFFFFFFFFFFFFFFFFFFBFFFFFFFFFFWWFFFFFFFFFW
WFFFFFFFWFFFFFFFFFFFFFFFFFFFFFFFFFFFFFFWWFFFFLFFFFW
WFFFFFFFWFFFFDFFFFFFWWWFFFFFFFFFFFFFFFFWWFFFFFFFFFW
WFFFFFFFWFFFFFFFFBFFWWWFFFFLFFFFFFFFWWWWWWWWFFFFFFW
WFFFFFFFWFFFFFFFFFFFWWWFFFFFFFFFFFFFFFFFFFFFFFFFFFW
WFFFFFFFWFFFFLFFFFFFWWWWWWWWWWWWFFFFFFFFFFFFFFFFFFW
WFFFFFFFFFFFFFFFFFFFWWWFFFFFFFFFFFFFFFFFFFFFFFFFFFW
WFFFFFFFFFFFFFFFFFFFWWWFFFFFFFFFFFFFFFFFFFDFFFFFFFW
WFFFFFFFFFFFFFFFFFFFWWWFFFFFFFFFFFFFFFFFFFFFFFFFFFW
WFFFFBFFFFFFFFFFFFFFWWWFFFFFFFFFFFFFFFFFFFFFFFFFFFW
WFFFFFFFFFFFFFFWWWWWWWWWWWFFFFFFFFFFFFBFFFFFFFFFFFW
WFFFFFFFFFFFFFFWFFFFFFFFFFFFFFFFFFFFFFFFFFFFFFFFFFW
WFFFFFFFFFFFFFFWFFFFFFFFFFFFFFFFFFFFFFFFFFFFFFFFFFW
WFFFFFFFFFFFFFFWFFFFFFFFFFFFFFFLFFFFFFFFFFFFFFFFFFW
WFFFFFFFFFFFFFFFFFFFFFFFFFFFFFFFFFFFFFFFFFFFFFFFFFW
WFFFFFFFFFFFFFFFFFFFFFFFFFWWWWWWWWWWWWFFFFFFFFFFFFW
WFFFFFFBFFFFFFFFFFFFFFFFFFFFFFWWWFFFFFFFFFFFFFFFFFW
WFFFFFFFFFFFFFDFFFFFFFFFFFFFFFWWWFFFFFFFFFFFFFFFFFW
WFFFFFFFFFFFFFFFFFFFFFFFFFFFFFWWWFFFFFFFFFFFFFFFFFW
WFFFFFFFFFFFFFFFFFFFFFFFFFFFFFWWWFFFFFFFFFFFFFFFFFW
WFFFFFFFWWWWWWWWWWWWWFFFFFFFFFWWWFFFFFFFFFBFFFFFFFW
WFFFFFFFFFWWWWWFFFFFFFFFFFFFFFFFFFFFFFFFFFFFFFFFFFW
WFFFFFFFFFWWWWWFFFFFFFFFFFFFFFFFFFFFFFFFFFFFFFFFFFW
WFFFFFFFFFWWWWWFFFFFFFFFFFFFFFFFFFFFFFFFFFFFFFFFFFW
WFFFFBFFFFWWWWWFFFFFWWWWFFFFFFFFFFFFFFFFFFFFFFFFFFW
WFFFFFFFFFWWWWWFFFFFWWWWFFFFFFFFFFFFFFFFFFFFFFFFFFW
WFFFFFFFFFWWWWWFFFFFWWWWFFFFFFFFFFFFFFFFFFFFFFFFFFW
WFFFFFFFFFWWWWWFFFFFWWWWFFFFFFFFFFFFFFFFFFFFFFFFFFW
WFFFFOFFFFWWWWWFFFFFWWWWFFFFFFFFFFFFFFFFFFFFFFFFFFW
WFFFFFFFFFWWWWWFFFFFWWWWWWWWWWWFFFFFFFFFFFFFFFFFFFW
WFWWWWWWWWWWWWWFFFFFFFFFFFFFFFFFFFFFFFFFFFFFFFFFFFW
WFWWWWWWWWWWWWWFFFFFFFFFFFFFFFFFFFFFFFFFFFFFFFFFFFW
WFFFFFFFFFFFFFFFFFFFFFFFFFFFFFFFFFFFFFFFFFFFFFFFFFW
WFFFFFFFFFFFFFFFFFFFFFFFFFFFFFFFFFFFFFFFBFFFFFFFFFW
WFFFFPFFFFFFFFFFFFFFFFFFFFFFFFFFFFFFFFFFFFFFFFFFFFW
WFFFFFFFFFFFFFFFFFFFFFFFFFFFFFFFFFFFFFFFFFFFFFFFFFW
WFFFFFFFFFFFFFFFFFFFFFFFFFFFFFFFFFFFFFFFFFFFFFFFFFW
WWWWWWWWWWWWWWWWWWWWWWWWWWWWWWWWWWWWWWWWWWWWWWWWWWW
