WWWWWWWWWWWWWWWWWWWWWWWWWWWWWWWWWWWWWWWWWWWWWWWWWWWWWWWWWWWWWWW
WFFFFFFFFFFFFWFFFFFFFFFFFFFFFFFFFFFFFFFFFFFFFFFFFFFFFFFFFFFFFFW
WFBFFFFFBFFFFWFFFFFFFFFFFFFFBFFFFFFFFFFFFFFFFFFLFFFFFFFFFFFFFFW
WFFFFFFFFFFFFWFFFFFFFFFFFFFFFFFFFFFFFFFFFFFFFFFFFFFFFFFFFFFFFFW
WFFFFFFFFFFFFWFFFFFFFFFFFFFFFFFFFFFFFFFFFFFFFFFFFFFFFFFFFFFFFFW
WFFFFFFFFFFFFFFFFFFFFFFFFFFFFFFWWWWWWWWWWWWWWWWWWWWWWWWWWFFFWWW
WFFFFFFFFFFFFFFFFFFFFFFFFFFFFFFWFFFFFFFFFFFFFFFFFFFFFFFFFFFFFFW
WFFFFFFFFFFFFFFFFFFFFFFFFFFFFFFWFFFFFFFFFFFFFFFFFFFFFFFFFFFFFFW
WFFFFFFFFFFFFWFFFFFFFFFFFFFFFFFWFFFFFFFFFFFFFFFFFFFFFFFFFFFFFFW
WFFFFFFFFFFFFWFFFFFFFFFFFFFFFFFWFFFFFFFFFFFFFFFFFFFFFFFFFFFFFFW
WFFFFFFFFFFFFWFFFFFFFFFFFFFFFFFWFFFFFFFFFFFFFFFFFFFFFFFFFFFFFFW
WFFFFHFFFFFFFWFFFFFFFFFFFFFFFFFWFFFFFFFFFFFFFFFFFFFFFFFFFFFFFFW
WFFFFFFFFFFFFWFFFFFFFFFFFFFFFFFWFFFFFFFFFFFFFFFFFFFFFFFFFFFFFFW
WFFFFFFFFFFFFWFFFFFFFFFFFFFFFFFWFFFFFFFFFFFFFFFFFFFFFFFFFFFFFFW
WWWWWWWWWWWWWWWWWWWWWWWWWWWWWWWWFFFFFWWWWWWWWWWWWWWWWWWWWWWWWWW
WFFFFFFFFFFFFFFFFFFFFFFFFFFFFFFWFFFFFFFFFFFFFFFFFFFFFFFFFFFFFFW
WFFFFFFFFFFFFFFFFFFFFFLFFFLFFFFWFFFFFFFFFFFFFFFFFFFFFFFFFFFFFFW
WFFFFFFFFFFFFFFFFFFFFFFFFFFFFFFWFFFFFFFFFFFFFFFFFFFFFFFFFFFFFFW
WWWFFFWWWWWWWWWWWWWWWWWWWWWWWWWWWWWWWWWWWWWWWWWWWWWFFFWWWWWWWWW
WFFFFFFFWFFFFFFFFFFFFFFFFFFFFFFFFFFFFFFFFFFFFFFFFFFFFFFFFFFFFFW
WFFFFFFFWFFFFFFFFFFFFFFFFFFFFFFFFFFFFFFFFFFFFFFFFFFFFFFFFFFFFFW
WFFFFFFFWFFFFFFFFFFFFFFFFFFFFFFFFFFFFFFFFFFFFFFFFFFFFFFFFFFFFFW
WFFFFFFFWFFFFFFFFFFFFFFFFFFFFFFFFFFFFFFFFFFFFFFFFFFFFFFFFFFFFFW
WFFFFFFFWFFFFWWWWWWWWWWWWWWWWWWWWWWWWWWWWWWWWWWWWWWWWWWWWWWWWWW
WFFFFFFFWFFFFFFFFFFFFFFFFFWFFFFFFFFFFFFFFFFFFFFFFFFFFFFFFFFFFFW
WFFFFFFFWFFFFFFFFFFFFFFFFFWFFFFFFFFFFFFFFFFFFFFFFFFFFFFFFFFFFFW
WFFFFFFFWFFFFBFFFFFFFFFFFFWFFFFFFFFFFFFLFFFFFFFFFFFFFFFFFFFFFFW
WFFFFFFFWFFFFFFFFFFFFFFFFFWFFFFFFFFFFFFFFFFFFFFFFFFFFFFFFFFFFFW
WFFFFFFFWFFFFFFFFFFFFFFFFFWFFFFFFFFFFFFFFFFFFFFFFFFFLFFFFFFFFFW
WFFFFFFFWFFFFFFFFFFFFFFFFFWFFFFFFFFFFFFFFFFFFFFFFFFFFFFFFFFFFFW
WFFFFFFFWFFFFFFFFFFFFFFFFFWFFFFFFFFFFFFFFFFFFFFWWWWWWWWWWWWFFFW
WFFFFFFFWFFFFFFFFFFFFFFFFFWFFFFFFFFFFFFFFFFFFFFWFFFFFFFFFFFFFFW
WFFFFFFFWFFFFFFFFFFFFFFFFFWFFFFFFFFFFFFFFFFFFFFWFFFFFFFFFFFFFFW
WFFFFFFFWFFFFFFFFFFFFFFFFFFFFFFFFFFFFFFLFFFFFFFWFFFFFFFFFFDFFFW
WFFFFFFFWFFFFFFFLFFFFFFFFFFFFFFFFFFFFFFFFFFFFFFWFFFFFFFFFFFFFFW
WFFFFFFFWFFFFFFFFFFFFFFFFFFFFFFFFFFFFFFFFFFFFFFWFFFFFFFFFFFFFFW
WFFFFFFFWFFFFFFFFFFFFFFFFFWFFFFFFFFFFFFFFFFFFFFWFFFFFFFFFFFFFFW
WFFFFFFFWWWWWWWWWWWWWWWWWWWWWWWWWWWWWWWWWWWWWWWWFFFWWWWWWWWWWWW
WFFFFFFFFFFFFFFFFFWFFFFFFFFFFFFFFFWFFFFFFFFFFFFFFFFFFFFFFFFFFFW
WFFFFFFFFFFFFFFFFFWFFFFFFFLFFFFFFFWFFFFFFFFFFFFFFFFFFFFFFFFFFFW
WFFFFFFFFFFFFFFFFFWFFFFFFFFFFFFFFFFFFFFFFFFFFFFFFFFFFFFFFFFFFFW
WFFFFFFFFFFFFFFFFFWFFFFFFFFFFFFFFFFFFFFFFFFFFFFFFFFFFFFFBFFFFFW
WFFFFFFFFFFFFFFFFFWFFFFFFFFFFFFFFFFFFFFFFFFFFFFFFFFFFFFFFFFFFFW
WFFFFFFFFFDFFFFFFFWFFFFFFFFFFFFFFFWFFFFFFFFFFFFFFFFFFFFFFFFFFFW
WFFFFFFFFFFFFFFFFFWFFFFFFFFFFFFFFFWFFFFFFFFFFFFFFFFFFFFFFFFFFFW
WFFFFFFFFFFFFFFFFFWFFFFFFFFFFFFFFFWFFFFFFFFFFFFFFFFFFFFFFFFFFFW
WFFFFFFFFFFFFFFFFFWFFFFFFFFFFFFFFFWFFFFFFFFFFBFFFFFFFFFFFFFFFFW
WFFFFFFFFFFFFFFFFFWFFFFFFFFFFFFFFFWFFFFFFFFFFFFFFFFFFFFFFFFFFFW
WFFFFFFFFFFFFFFFFFWFFFFFFFFDFFFFFFWFFFFFFFFFFFFFFFFFFFFFFFFFFFW
WFFFFFFFFFFFFFFFFFFFFFFFFFFFFFFFFFWFFFFFFFFFFFFFFFFFFFFFFFFFFFW
WFFFFFFFFFFFFFFFFFFFFFFFFFFFFFFFFFWFFFFFFFFFFFFFFFFFFFFFFFFFFFW
WFFFFFFFFFFFFFFFFFFFFFFFFFFFFFFFFFWFFFFFFFFFFFFFFFFFFBFFFFFFFFW
WFFFFFFFFFFFFFFFFFWFFFFFFFFFFFFFFFWFFFFFFFFFFFFFFFFFFFFFFFFFFFW
WFFFFFFFFFFFFFFFFFWFFFFFFFFFFFFFFFWFFFFFFFFFFFFFFFFFFFFFFFFFFFW
WWWWFFFWWWWWWWWWWWWWWWWWWWWWWWWWWWWFFFFFFFFWWWWWWWWWWWFFFFFFFFW
WFFFFFFFFFWFFFFFFFFFFFFFFFFFFFFFFFFFFFFFFFFFFFFFFFFFFFFFFFFFFFW
WFFFFOFFFFWFFFFFFFFFFFFFFFFFFFFFFFFFFFFFFFFFFFFFFFFFFFFFFFFFFFW
WFFFFFFFFFWFFFFFFFFFFFFFFFFFFBFFFFFFFFFFFFFFFFFFFFFFFFFFFFFFFFW
WFFFFFFFFFWFFFFFFFFFFFFFFFFFFFFFFFFFFFFFFFFFFFFFFFFFFFFFFFFFFFW
WFFFFFFFFFWFFFFFFFFFFFFFFFFFFFFFFFFFFFFFFFFFFFFFFFFFFFFFFFFFFFW
WFFFFPFFFFWFFFFFFFFFFFFFFFFFFBFFFFFFFFFFFFFFFFFFFFFFFFFFFFFFFFW
WFFFFFFFFFWFFFFFFFFFFFFFFFFFFFFFFFFFFFFFFFFFFFFFFFFFFFFFFFFFFFW
WWWWWWWWWWWWWWWWWWWWWWWWWWWWWWWWWWWWWWWWWWWWWWWWWWWWWWWWWWWWWWW
