WWWWWWWWWWWWWWWWWWWWW
WFFFFFFFFFFFFFFFFFFFW
WFFFFFFFFFFFFFFFFLFFW
WFFFFFFFFFFFFFFFFFFFW
WFFPFFOFFFFFFFFFFHFFW
WFFFFFFFFFFFFFFFFFFFW
WFFFFFFFFFFFFFFFFLFFW
WFFFFFFFFFFFFFFFFFFFW
WWWWWWWWWWWWWWWWWWWWW
