WWWWWWWWWWWWWWWWWWWWWWWWWWW
WFFFFFFFFFFFFFFFFFFFFFFFFFW
WFFFFFFFFFFFFFFFFFFFFFFFFFW
WFFFFFFFFFFFFFFFFFFFFFFFFFW
WFFPFFFOFFFFFFFFFFDFFFFHFFW
WFFFFFFFFFFFFFFFFFFFFFFFFFW
WFFFFFFFFFFFFFFFFFFFFFFFFFW
WFFFFFFFFFFFFFFFFFFFFFFFFFW
WWWWWWWWWWWWWWWWWWWWWWWWWWW
